1111111111111111111111111111111111
1E0000000000000C00000C000000000001
1010010100100000101001000000010101
1000010010101010001001000000010101
10P0000000C00C000000000C0000000001
100001001010101000100100000001010
1111111111111111111111111111111111
