11111111111111111111111111111111111111111111111111111111111111111111
1E0000000000000C00000C000000000001E0000000000000C00000C0000000000011
10100101001000001010010000000101000100101001000001010010000000101001
10000100101010100010010000000101000000010010101010001001000000010101
10P0000000C00C000000000C000000000000P0000000C00C000000000C0000000001
10000100101010100010010000000101011000010010101010001001000000010101
111111111011111CCC11111111111111111CCCCCCCCCC11111111111C11111111111
111111111011111CCC11111111111111000000000000011111111111C11111111111
1E0000000000000C00000C00000000000CCE0000000000000C00000C000000000001
101001010010000010100100000001010CC010010100100000101001000000010101
100001001010101000100100000001010CC000010010101010001001000000010101
10P0000000C00C000000000C000000000100P0000000C00C000000000C0000000001
10000100101010100010010000000101010000010010101010001001000000010101
1E0000000000000C00000C0000000000010E0000000000000C00000C000100000001
10100101001000001010010000000101000010010100100000101001000000010101
10000100101010100010010000000101000000010010101010001001000000010101
10P0000000C00C000000000C000000000000P0000000C00C000000000C0000000001
100001001010101000100100000001010CC000010010101010001001000000010101
1E0000000000000C00000C0000000000011E0000000000000C00000C000000000001
10100101001000001011101001000010101101001010010000101001000000010101
10000100101010100011110000000101000000010010101010001001000000010101
10P0000000C00C000000000C000000000110P0000000C00C001000000C0000000001
100001001010111000100100000001010CC000010010101010001001000000010101
1E0000000000010C00000C000000000000000000000000000C00000C000000000001
10100101001000001010010000000101000010010100000000000001000000010101
10000100111010100010010000000101000000C00000100111111010000000101011
10P0000000C00C000000000C000000000000P0000001C001CCCC1C000C0000000001
1000010010101010001001000000010100000000001C000000001C01000000010101
10P0000000C00C000000000C000000000110P00001C0000000001C000C0000000001
100001001010101000100100100001010CC000001C0000000001C000001000010101
1E0000000000000C00000C00000000000000000011111100001C000C000000000001
10100101001000001110010000000101000010000CCCC1C001C00000000000010101
1000010010101010001001000000010100000000000001C01C000000000000101011
10P0000000C00C001100000C000000000000P000000001C0111110000C0000000001
1000010010101010001001000000010100000001001000C00CCCCC00000000010101
10P0000000C00C000000000C000000000110P00000000000000000000C0000000001
100001001010101000100100000001010CC000010010101010001001000100010101
1E0000000000000C00000C000000000000000000000000000C00000C000000000001
10100101001000001010010000000101000010010100100000101001000000010101
11111111111111111111111111111111111111111111111111111111111111111111
